##############################################################.
-.......................................=.....................-
-FFFFFFFFFFFFFFFFFFFFFFFFFFFFFFFFFFF....=.....................-
-FFFFFFFFFFFFFFFFFFFFFFFFFFFFFFFFFFF....=.....................-
-FFFFFFFFFFFFFFFFFFFFFFFFFFFFFFFFFFF....=.............S.......-
-FFFFFFFFFFFFFFFFFFFFFFFFFFFFFFFFFFF....=.....................-
-FFFFFFFFFFFFFFFFFFFFFFFFFFFFFFFFFFF....=.....................-
-FFFFFFFFFFFFFFFFFFFFFFFFFFFFFFFFFFF....=#########............-
-FFFFFFFFFFFFFFFFFFFFFFFFFFFFFFFFFFF..........................-
-FFFFFFFFFFFFFFFFFFFFFFFFFFFFFFFFFFF..........................-
-FFFFFFFFFFFFFFFFFFFFFFFFFFFFFFFFFFF..................P.......-
-FFFFFFFFFFFFFFFFFFFFFFFFFFFFFFFFFFF..........................-
-FFFFFFFFFFFFFFFFFFFFFFFFFFFFFFFFFFF..........................-
-FFFFFFFFFFFFFFFFFFFFFFFFFFFFFFFFFFF....=$$$$$$$$$............-
-FFFFFFFFFFFFFFFFFFFFFFFFFFFFFFFFFFF....=.....................-
-FFFFFFFFFFFFFFFFFFFFFFFFFFFFFFFFFFF....=.....................-
-FFFFFFFFFFFFFFFFFFFFFFFFFFFFFFFFFFF....=.............Q.......-
-FFFFFFFFFFFFFFFFFFFFFFFFFFFFFFFFFFF....=.....................-
-FFFFFFFFFFFFFFFFFFFFFFFFFFFFFFFFFFF....=.....................-
-.......................................=.....................-
$$$$$$$$$$$$$$$$$$$$$$$$$$$$$$$$$$$$$$$$$$$$$$$$$$$$$$$$$$$$$$.