.........................................######################
#########################################.....................#
#.......................................#.....................#
#.FFFFFFFFFFFFFFFFFFFFFFFFFFFFFFFFFF....#.....................#
#.FFFFFFFFFFFFFFFFFFFFFFFFFFFFFFFFFF....#.............S.......#
#.FFFFFFFFFFFFFFFFFFFFFFFFFFFFFFFFFF....#.....................#
#.FFFFFFFFFFFFFFFFFFFFFFFFFFFFFFFFFF....#.....................#
#.FFFFFFFFFFFFFFFFFFFFFFFFFFFFFFFFFF....#.....................#
#.FFFFFFFFFFFFFFFFFFFFFFFFFFFFFFFFFF....##########............#
#.FFFFFFFFFFFFFFFFFFFFFFFFFFFFFFFFFF..........................#
#.FFFFFFFFFFFFFFFFFFFFFFFFFFFFFFFFFF..................P.......#
#.FFFFFFFFFFFFFFFFFFFFFFFFFFFFFFFFFF..........................#
#.FFFFFFFFFFFFFFFFFFFFFFFFFFFFFFFFFF....##########............#
#.FFFFFFFFFFFFFFFFFFFFFFFFFFFFFFFFFF....#.....................#
#.FFFFFFFFFFFFFFFFFFFFFFFFFFFFFFFFFF....#.....................#
#.FFFFFFFFFFFFFFFFFFFFFFFFFFFFFFFFFF....#.....................#
#.FFFFFFFFFFFFFFFFFFFFFFFFFFFFFFFFFF....#.............Q.......#
#.FFFFFFFFFFFFFFFFFFFFFFFFFFFFFFFFFF....#.....................#
#.......................................#.....................#
#########################################.....................#
.........................................######################